***************************
*.........................*
*.**********.**.*********.*
*.**********.**.*********.*
*......**....**...**......*
***.**.**.*******.**.**.***
***.**.**.*******.**.**.***
*...**...............**...*
*.****.*****.**.****.****.*
*.****.*****.**.****.****.*
*............**...........*
******.**.*******.**.******
******.**.*******.**.******
******.**.........**.******
******.**.*******.**.******
******.**.*.. ..*.**.******
..........*.....*..........
******.**.*.....*.**.******
******.**.***..**.**.******
******.**.........**.******
******.*****.**.****.******
******.*****.**.****.******
*......**....**...**......*
*.****.**.*******.**.****.*
*.****.**.*******.**.****.*
*.........................*
*.****.*****.**.****.****.*
*.****.*****.**.****.****.*
*.****.*****.**.****.****.*
*............**...........*
***************************
